********************
*                  *
* ****** ********* *
* *    *    *    * *
* * ********* *  * *
*   *         *    *
***** ******* ******
E       *          *
****************** *
*                  *
* ***************  *
* *                *
*** ****************
* *                *
* ***** *********  *
*       *          *
******* * **********
*S      *          *
********************