*E*******
*       *
*   *** *
* * *   *
* * * * *
* * *S* *
**   *  *
*       *
*********