*********
* * * * *
* ***** *
* * * * *
* * *** *
* * * * *
* ***** *
* * * * *
*********