*E*******
*    *  *
*   *** *
* * *   *
* * *** *
*   *   *
**  S * *
*    *  *
*********
