*E*******
*       *
*   ***  
* * *    
* * * * *
* * * * *
**  S*   
*       *
*********