*E*******
*    *   
*   *** *
* * *   *
* * *** *
*   *   *
**  S * *
*    *   
*********
