*********
*       *
* ***** *
* *     *
* * *** *
E *  S* *
******* *
*       *
*********