**************E**
*______________**
*___***********_*
*_*_*___________*
*_*_*_*_*_*******
*_*_*_*_*_____S_*
*_*_*_*_*_______*
*_*_*_*_*__******
*_*_*_*_*__*___**
*_*_*_*_*__*_*_**
*_*_*_*_*__*_*_**
*_*_*_*_*__*_*_**
*_*_*___*__*_*_**
*_*___*_*_______*
*****************